11111111111111
1P0000000C0001
1011C110111001
1010000C101001
1010C110101001
10000C00001001
1011111C101001
1010000E101001
1010C110111001
10000C0C000001
1C000000000001
11111111111111