1111111111111111111111111
1P00C0C00C000C0C00C0C00C1
1011111111011111011111101
1C0C00C0C00C0C00C0C0C0C01
1010111101011111010111101
10C00C00001000C0C0000C001
1011111110111111110111101
10C00C0C0C0000C0C0C0C0001
1010111110111111110111101
1C0C00C00C0000C00C0C0C0C1
1010111111111111011111101
10C0C0C0000000C00C00C0C01
1011111110111111110111101
1C00C0C00000C0C0C0C00C0E1
1111111111111111111111111