111111
1P1111
101011
101111
1C1001
101111
1E1111
1C1111
111111