111111111111
1P000000C0E1
101111011101
1C00010100C1
111101011101
1C000C0000C1
101110111101
1C00000000C1
111111111111