1111111111
1P0000C001
1011C11001
1010C00101
1010C10101
1000C01001
1C1011C001
1C00C00001
1000C000E1
1111111111