1111111111
1P0000C0E1
1011C11001
1C10C00101
1010010101
1000C01001
1010111001
1C000C0001
1000C00001
1111111111