111111111111111
1P0000000C00001
1011111C1101001
1010000C10100E1
1010C1101C10001
10000C0000C0001
1C00C1C00010001
111111111111111