1111111111111111111
1P0000000000C0000E1
1011111C11111011111
1010000C10000010001
1010C1101C111C10101
10000C0000C00000101
1C00C1C0001000C0101
10101111101110C0101
1C00000000000C000C1
1111111111111111111