11111111111111111111
1P000CC000000C0000C1
10111110111101110101
1010000000C000000001
10101111010111110101
10000C000010000C0001
10111111101111111101
10100C0000C00000E001
10101111011110111001
1C0000000000C0C000C1
11111111111111111111