111111111111
1P00000PC001
101111111111
10C000000011
1011C1111011
101111111C01
1C1111111101
1C00C1111EC1
111111111111