1111111
1P11111
1001011
1011111
1E10001
1011111
1C10001
1011111
1C10001
1011111
1001011
1011111
1C10001
1011111
1000011
1010111
1111111